Astrocyte	Astrocyte
Cortical_neuron	Cortical_neuron
Dopaminergic_neuron	Dopaminergic_neuron
H9_differentiated_forebrain	H9_differentiated_forebrain
H9_differentiated_mesenchymal	H9_differentiated_mesenchymal
H9_differentiated_midbrain	H9_differentiated_midbrain
iPSC_neuron	iPSC_neuron
Neural_stem	Neural_stem
Embryonic_stem	Embryonic_stem
iPSC_cardiomyocyte	iPSC_cardiomyocyte
Endothelial	Endothelial
Biliosphere	Biliosphere
Bronchial_epithelial	Bronchial_epithelial
Colonic_epithelial	Colonic_epithelial
Islet_alpha	Islet_alpha
Islet_beta	Islet_beta
Keratinocyte_epithelial	Keratinocyte_epithelial
Mammary_epithelial	Mammary_epithelial
Prostate_epithelial	Prostate_epithelial
Renal_epithelial	Renal_epithelial
Retinal_pigment_epithelial	Retinal_pigment_epithelial
Fibroblast	Fibroblast
Smooth_muscle	Smooth_muscle
Valve_interstitial	Valve_interstitial
Mesangial	Mesangial
Myoblast	Myoblast
Myotube	Myotube
Melanocyte	Melanocyte
Corona_radiata	Corona_radiata
Cumulus_oophorus	Cumulus_oophorus
Chondrocyte	Chondrocyte
Osteoblast	Osteoblast
B_lymphocyte_CD77	B_lymphocyte_CD77
B_lymphocyte_centroblast	B_lymphocyte_centroblast
B_lymphocyte_centrocyte	B_lymphocyte_centrocyte
B_lymphocyte_memory	B_lymphocyte_memory
B_lymphocyte_naive	B_lymphocyte_naive
B_lymphocyte_pregerminal_center	B_lymphocyte_pregerminal_center
Plasma	Plasma
CD3_T_lymphocyte	CD3_T_lymphocyte
CD4_T_lymphocyte	CD4_T_lymphocyte
CD8_T_lymphocyte	CD8_T_lymphocyte
Dendritic	Dendritic
Macrophage	Macrophage
Monocyte	Monocyte
CD14_monocyte	CD14_monocyte
Platelet	Platelet
Red_blood	Red_blood
